5,16
++++++++++++++++
+              +
+              +
+s            g+
++++++++++++++++